2
4 4
0
5
0 3 6 3 6 5 1 5 1 6
0
5
0 3 6 3 6 5 1 5 1 4
0
4
0 3 6 3 6 5 1 5
0
4
0 3 6 3 6 5 2 6
0
5
0 10 6 10 6 8 1 8 1 7
0
5
0 10 6 10 6 8 1 8 1 9
0
4
0 10 6 10 6 8 1 8
0
4
0 10 6 10 6 8 2 8