2
6 6
0
14
4 13 4 10 2 10 2 12 4 12 4 10 2 10 2 12 4 12 4 10 2 10 2 12 4 12 4 10
1
14
4 13 4 10 2 10 2 12 4 12 4 10 2 10 2 12 4 12 4 10 2 10 2 12 4 12 4 11
2
13
4 13 4 10 2 10 2 12 4 12 4 10 2 10 2 12 4 12 4 10 2 10 2 12 4 12
3
13
4 13 4 10 2 10 2 12 4 12 4 10 2 10 2 12 4 12 4 10 2 10 2 12 3 12
2
12
4 13 4 10 2 10 2 12 4 12 4 10 2 10 2 12 4 12 4 10 2 10 2 12
1
12
4 13 4 10 2 10 2 12 4 12 4 10 2 10 2 12 4 12 4 10 2 10 2 11
0
14
4 0 4 3 2 3 2 1 4 1 4 3 2 3 2 1 4 1 4 3 2 3 2 1 4 1 4 3
1
14
4 0 4 3 2 3 2 1 4 1 4 3 2 3 2 1 4 1 4 3 2 3 2 1 4 1 4 2
2
13
4 0 4 3 2 3 2 1 4 1 4 3 2 3 2 1 4 1 4 3 2 3 2 1 4 1
3
13
4 0 4 3 2 3 2 1 4 1 4 3 2 3 2 1 4 1 4 3 2 3 2 1 3 1
2
12
4 0 4 3 2 3 2 1 4 1 4 3 2 3 2 1 4 1 4 3 2 3 2 1
1
12
4 0 4 3 2 3 2 1 4 1 4 3 2 3 2 1 4 1 4 3 2 3 2 2