2
3 3
0
14
3 13 3 10 2 10 2 11 3 11 3 10 2 10 2 11 3 11 3 10 2 10 2 11 3 11 3 7
0
14
3 13 3 10 2 10 2 11 3 11 3 10 2 10 2 11 3 11 3 10 2 10 2 11 3 11 3 8
0
14
3 13 3 10 2 10 2 11 3 11 3 10 2 10 2 11 3 11 3 10 2 10 2 11 3 11 3 9
1
14
3 0 3 3 2 3 2 2 3 2 3 3 2 3 2 2 3 2 3 3 2 3 2 2 3 2 3 6
1
14
3 0 3 3 2 3 2 2 3 2 3 3 2 3 2 2 3 2 3 3 2 3 2 2 3 2 3 5
1
14
3 0 3 3 2 3 2 2 3 2 3 3 2 3 2 2 3 2 3 3 2 3 2 2 3 2 3 4