1
8
0
5
6 13 6 1 1 1 1 12 2 12
0
4
6 13 6 1 1 1 1 12
0
4
6 13 6 1 1 1 1 11
0
4
6 13 6 1 1 1 1 10
0
4
6 13 6 1 1 1 1 3
0
4
6 13 6 1 1 1 1 2
0
3
6 13 6 1 1 1
0
3
6 13 6 1 2 1
