3
2 2 7
1
2
0 6 6 6
3
2
0 6 3 6
1
2
0 7 6 7
3
2
0 7 3 7
1
22
4 13 4 5 2 5 2 8 4 8 4 5 2 5 2 8 4 8 4 5 2 5 2 8 4 8 4 5 2 5 2 8 4 8 4 5 2 5 2 8 5 8 5 5
1
22
4 13 4 5 2 5 2 8 4 8 4 5 2 5 2 8 4 8 4 5 2 5 2 8 4 8 4 5 2 5 2 8 4 8 4 5 2 5 2 8 5 8 5 6
1
22
4 13 4 5 2 5 2 8 4 8 4 5 2 5 2 8 4 8 4 5 2 5 2 8 4 8 4 5 2 5 2 8 4 8 4 5 2 5 2 8 5 8 5 7
1
22
4 13 4 5 2 5 2 8 4 8 4 5 2 5 2 8 4 8 4 5 2 5 2 8 4 8 4 5 2 5 2 8 4 8 4 5 2 5 2 8 4 8 4 5
1
22
4 13 4 5 2 5 2 8 4 8 4 5 2 5 2 8 4 8 4 5 2 5 2 8 4 8 4 5 2 5 2 8 4 8 4 5 2 5 2 8 4 8 4 6
1
22
4 13 4 5 2 5 2 8 4 8 4 5 2 5 2 8 4 8 4 5 2 5 2 8 4 8 4 5 2 5 2 8 4 8 4 5 2 5 2 8 4 8 4 7
1
21
4 13 4 5 2 5 2 8 4 8 4 5 2 5 2 8 4 8 4 5 2 5 2 8 4 8 4 5 2 5 2 8 4 8 4 5 2 5 2 8 4 8