4
2 2 2 2
0
4
6 13 6 10 4 10 4 12
0
4
6 13 6 10 4 10 4 11
3
4
1 13 1 10 3 10 3 12
3
4
1 13 1 10 3 10 3 11
2
4
6 0 6 3 4 3 4 1
2
4
6 0 6 3 4 3 4 2
1
4
1 0 1 3 3 3 3 1
1
4
1 0 1 3 3 3 3 2
