2
3 7
0
22
0 6 3 6 3 7 2 7 2 6 3 6 3 7 2 7 2 6 3 6 3 7 2 7 2 6 3 6 3 7 2 7 2 6 3 6 3 7 2 7 2 6 3 6 3 7 2 7 2 6 3 6
0
21
0 6 3 6 3 7 2 7 2 6 3 6 3 7 2 7 2 6 3 6 3 7 2 7 2 6 3 6 3 7 2 7 2 6 3 6 3 7 2 7 2 6 3 6 3 7 2 7 2 6
0
20
0 6 3 6 3 7 2 7 2 6 3 6 3 7 2 7 2 6 3 6 3 7 2 7 2 6 3 6 3 7 2 7 2 6 3 6 3 7 2 7 2 6 3 6 3 7 2 7
2
22
0 5 3 5 4 6 4 7 3 8 2 8 1 7 1 6 2 5 3 5 4 6 4 7 3 8 2 8 1 7 1 6 2 5 3 5 4 6 4 7 3 8 3 7
2
17
0 5 3 5 4 6 4 7 3 8 2 8 1 7 1 6 2 5 3 5 4 6 4 7 3 8 2 8 1 7 1 6 2 5
2
16
0 5 3 5 4 6 4 7 3 8 2 8 1 7 1 6 2 5 3 5 4 6 4 7 3 8 2 8 1 7 1 5
2
16
0 5 3 5 4 6 4 7 3 8 2 8 1 7 1 6 2 5 3 5 4 6 4 7 3 8 2 8 1 7 1 6
2
15
0 5 3 5 4 6 4 7 3 8 2 8 1 7 1 6 2 5 3 5 4 6 4 7 3 8 2 8 1 7
2
15
0 5 3 5 4 6 4 7 3 8 2 8 1 7 1 6 2 5 3 5 4 6 4 7 3 8 2 8 1 8
2
14
0 5 3 5 4 6 4 7 3 8 2 8 1 7 1 6 2 5 3 5 4 6 4 7 3 8 2 8